19 18 18 18 18 18 18 18 18 19 18 18 18 18 18 18 18 18 18 18 18 18 18 18 18 18 18 18 18 18 18 18 18 19 18 19 18 19 19 18 19 18 19 19 18 18 18 18 18 18 
18 18 19 19 19 19 18 18 18 18 18 18 18 18 18 18 18 18 18 18 18 18 18 18 18 18 18 18 18 18 19 19 19 18 18 18 18 18 18 18 18 18 18 18 18 18 18 18 18 18 
18 18 18 18 18 19 19 18 19 18 19 18 18 19 19 19 19 19 19 19 19 19 19 19 19 19 18 18 18 18 18 19 19 19 19 18 19 18 19 18 19 18 19 18 19 18 19 18 19 18 
18 18 18 18 18 19 18 18 18 18 18 18 19 19 18 18 18 18 18 18 18 18 18 19 18 19 19 19 19 19 18 18 18 18 18 18 18 18 18 18 18 18 18 18 18 18 18 18 18 19 
18 18 18 18 19 19 18 18 18 18 18 18 18 18 19 18 19 18 19 18 19 18 19 18 19 19 18 18 18 18 18 18 18 18 18 18 18 18 18 18 18 18 18 18 18 18 18 18 19 19 
18 18 18 18 19 18 19 18 18 18 18 18 18 19 18 19 18 18 19 18 19 18 18 18 18 18 18 18 18 18 18 18 18 19 19 19 19 18 19 18 19 18 19 18 19 18 18 19 18 19 
18 19 19 18 19 19 19 19 19 18 19 18 18 18 18 18 18 18 18 18 18 18 19 18 19 19 19 18 18 18 18 18 18 18 18 18 18 18 18 18 18 18 18 18 18 18 18 18 18 18 
19 18 18 18 18 19 19 18 18 18 18 18 18 19 18 19 18 19 18 19 19 19 19 19 19 19 18 18 18 18 18 18 18 18 18 18 18 18 18 19 18 19 18 19 18 18 19 18 19 18 
18 18 19 18 19 18 19 18 18 18 18 18 18 18 18 18 18 18 18 18 18 18 18 18 18 18 19 19 19 19 19 18 19 18 19 18 19 18 18 18 18 18 18 18 18 18 18 18 18 18 
18 19 18 18 18 18 19 18 18 18 18 18 18 18 18 18 18 18 18 18 18 18 19 19 19 18 18 18 18 18 18 18 18 18 18 18 18 18 18 18 18 18 18 18 18 18 18 18 18 18 
18 19 19 18 18 19 19 18 18 19 19 19 19 19 19 19 19 19 19 19 19 19 19 19 19 19 19 19 19 19 19 19 19 19 19 19 19 19 19 19 19 18 18 18 18 18 18 18 18 18 
18 19 19 18 18 19 18 18 18 19 19 3 3 3 3 3 3 3 3 3 3 3 3 3 3 3 3 3 3 3 3 3 3 3 3 3 3 3 3 19 19 18 18 18 18 18 18 18 18 18 
18 19 19 18 19 19 18 18 18 19 3 3 3 3 3 3 3 3 3 3 3 3 3 3 3 3 3 3 3 3 3 3 3 3 3 3 3 3 3 3 19 18 18 18 19 19 18 18 18 18 
18 18 18 18 19 18 18 18 18 19 3 3 4 5 5 5 5 5 5 5 5 5 5 5 5 5 5 5 5 5 5 5 5 5 5 5 5 8 3 3 19 18 19 18 19 19 18 18 18 18 
18 18 18 19 19 18 18 18 18 19 3 3 7 2 2 2 16 16 16 16 16 16 16 2 2 2 2 16 16 16 16 16 16 16 16 16 16 8 3 3 19 18 19 18 18 19 18 18 18 18 
18 18 18 19 18 18 18 18 18 19 3 3 7 2 16 16 16 16 16 16 16 16 1 1 1 1 1 1 2 1 16 1 16 16 16 16 16 8 3 3 19 18 19 18 18 18 18 18 18 19 
18 18 18 18 18 18 18 18 18 19 3 3 7 1 16 16 1 16 33 1 33 2 3 3 3 3 3 3 3 1 2 2 2 33 33 1 1 8 3 3 19 19 18 18 18 18 19 18 19 19 
18 18 18 18 18 18 18 18 18 19 3 3 7 16 16 1 33 1 1 1 1 1 1 20 21 21 22 2 1 33 2 1 1 16 16 16 16 8 3 3 19 19 18 19 18 18 19 18 18 19 
18 18 18 18 18 18 18 18 18 19 3 3 7 1 3 1 1 16 33 16 16 3 1 23 19 19 24 1 16 16 16 2 3 1 33 1 16 8 3 3 19 18 19 19 18 18 18 18 18 18 
18 18 18 18 18 18 18 18 18 19 3 3 7 3 3 16 33 16 16 2 2 3 1 25 26 26 27 2 16 16 16 1 3 2 1 16 16 8 3 3 19 18 18 18 18 18 19 18 18 19 
19 18 19 19 18 18 18 18 18 19 3 3 7 2 16 16 16 16 16 16 16 3 2 1 2 2 2 1 1 1 1 3 3 3 1 16 16 8 3 3 19 18 18 19 18 18 18 18 19 18 
19 18 18 19 19 18 19 19 19 19 3 3 7 16 1 2 2 16 16 2 1 3 1 1 1 1 3 3 3 3 3 3 3 3 1 16 16 8 3 3 19 18 19 18 18 18 18 18 19 18 
19 18 18 18 19 19 18 19 19 19 3 3 7 1 3 1 3 3 3 3 3 3 3 2 2 16 16 2 2 1 1 3 3 3 3 2 16 8 3 3 19 18 19 18 18 18 18 18 19 18 
19 18 18 18 19 19 18 19 19 19 3 3 7 1 3 1 1 1 1 1 2 2 2 2 16 16 16 16 16 1 1 1 3 1 2 1 16 8 3 3 19 18 19 18 18 18 18 18 19 18 
18 18 18 18 19 19 18 19 19 19 3 3 7 1 3 1 16 16 16 16 16 16 2 2 16 16 16 16 16 16 16 16 3 2 2 1 1 8 3 3 19 18 18 18 18 18 18 18 18 18 
18 19 18 18 19 18 18 19 19 19 3 3 7 1 3 16 16 16 16 16 16 16 2 2 2 2 16 16 16 16 1 1 3 1 2 1 1 8 3 3 19 18 19 18 18 19 18 18 18 18 
18 18 18 18 19 18 19 19 18 19 3 3 7 1 3 1 1 1 3 3 3 3 3 3 3 3 3 3 3 1 1 33 33 33 1 1 1 8 3 3 19 18 19 18 18 19 19 18 18 18 
18 19 18 18 19 18 19 19 18 19 3 3 2 1 3 3 3 3 3 2 1 1 1 33 16 1 1 3 3 3 3 1 33 1 1 1 3 8 3 3 19 18 19 18 18 18 18 18 18 18 
18 18 18 19 19 18 18 19 18 19 3 3 7 1 16 1 2 2 20 21 22 2 16 33 2 33 2 3 2 2 20 21 21 21 21 22 3 8 3 3 19 18 19 18 18 18 18 18 18 18 
18 19 19 18 19 18 19 19 18 19 3 3 7 1 16 16 1 1 25 26 27 1 1 16 1 33 3 3 1 1 23 19 19 19 19 24 3 8 3 3 19 18 19 18 18 18 18 18 19 18 
18 18 18 18 19 18 19 18 18 19 3 3 7 16 16 1 1 1 1 1 1 1 1 1 16 1 3 1 1 1 25 26 26 26 26 27 3 8 3 3 19 18 19 18 19 18 18 18 19 18 
18 19 19 18 19 18 19 18 18 19 3 3 7 33 33 33 2 2 2 2 16 3 3 3 3 3 3 3 3 3 3 3 1 1 1 1 3 8 3 3 19 18 19 18 19 18 18 18 19 18 
19 19 18 18 19 18 19 18 18 18 3 3 7 2 1 1 1 16 16 16 16 16 16 16 16 16 16 16 16 16 16 16 16 16 16 1 1 8 3 3 19 18 19 18 19 18 18 18 19 18 
19 19 18 18 19 18 19 18 19 18 3 3 7 2 2 2 3 1 16 16 16 16 16 16 16 16 16 16 16 16 16 16 16 16 2 2 2 8 3 3 19 18 19 18 19 18 18 19 19 18 
19 19 18 18 19 19 19 18 18 18 3 3 7 1 16 16 3 2 2 16 32 32 32 32 32 32 32 32 32 32 32 32 16 1 1 1 1 8 3 3 19 18 19 18 19 18 18 19 18 18 
19 19 18 18 18 19 19 18 18 18 3 3 7 1 2 2 3 16 16 16 1 1 33 33 16 33 1 1 16 33 2 3 3 3 3 3 16 8 3 3 19 18 18 18 18 18 18 19 18 18 
19 19 18 18 18 18 19 19 18 19 3 3 7 3 3 3 3 3 3 3 3 3 3 16 16 1 1 16 1 1 1 1 1 1 1 1 16 8 3 3 19 18 18 18 19 18 18 19 18 18 
18 19 18 18 18 19 19 18 18 19 3 3 9 10 10 10 10 10 10 10 10 10 10 10 10 10 10 10 10 10 10 10 10 10 10 10 10 11 3 3 19 18 18 18 19 18 18 19 18 18 
19 19 18 18 18 19 19 18 18 19 3 3 3 3 3 3 3 3 3 3 3 3 3 3 3 3 3 3 3 3 3 3 3 3 3 3 3 3 3 3 19 18 18 19 18 18 18 18 18 18 
18 19 18 18 19 18 19 18 18 19 19 3 3 3 3 3 3 3 3 3 3 3 3 3 3 3 3 3 3 3 3 3 3 3 3 3 3 3 3 19 19 18 18 19 18 18 18 18 18 18 
19 18 19 18 19 18 19 18 18 19 19 19 19 19 19 19 19 19 19 19 19 19 19 19 19 19 19 19 19 19 19 19 19 19 19 19 19 19 19 19 19 18 18 18 18 18 18 18 18 18 
18 18 19 18 18 18 19 18 18 18 18 18 18 18 18 18 18 18 18 18 18 18 18 18 18 18 18 18 18 18 18 18 18 18 18 18 18 18 18 18 18 18 18 18 18 18 18 18 18 18 
19 18 19 18 18 19 18 18 19 18 18 18 19 18 19 19 19 19 19 19 19 19 19 19 18 18 18 18 18 18 18 18 18 19 19 19 19 19 18 19 18 19 18 18 18 18 18 18 18 18 
19 19 19 18 18 18 19 19 18 18 19 19 19 19 18 18 19 19 19 19 19 19 18 18 18 19 18 19 18 18 18 18 18 18 18 18 18 18 18 18 18 18 19 18 19 19 19 18 18 18 
19 19 19 18 19 19 18 18 18 18 18 18 18 18 18 18 18 18 18 18 18 18 18 18 18 18 18 18 18 18 19 19 18 18 18 18 19 19 18 18 18 18 18 18 19 19 19 18 18 18 
19 19 18 18 19 19 19 19 18 19 18 18 19 18 18 19 18 18 19 18 18 19 18 18 19 18 18 19 18 19 18 19 18 18 18 18 18 18 18 18 19 18 19 18 18 18 18 18 18 18 
19 19 18 18 18 19 19 19 19 18 18 18 18 18 18 19 19 19 19 18 18 18 18 18 18 18 18 18 18 18 18 18 18 18 18 18 18 18 19 18 18 18 18 18 18 18 18 18 18 18 
19 19 18 18 18 19 19 18 18 19 18 19 18 18 18 18 19 19 18 19 19 19 19 18 18 18 18 18 18 18 18 19 18 19 18 19 18 19 18 18 19 18 19 19 19 18 19 18 18 18 
18 19 18 18 18 19 19 18 18 18 18 18 19 18 18 18 18 18 19 19 19 19 18 19 19 19 18 18 19 19 19 19 18 19 18 18 18 18 19 18 19 18 18 19 19 19 19 19 19 18 
18 19 18 18 18 18 18 18 18 18 18 18 18 19 19 18 18 18 18 18 18 18 19 19 19 18 18 18 18 18 18 18 18 18 19 19 19 18 18 18 18 18 18 18 19 19 18 18 18 18 
