32 32 32 32 32 32 32 32 32 32 32 32 32 32 32 32 32 32 32 32 32 32 32 32 32 32 32 32 32 32 32 32 32 32 32 32 32 32 32 32 32 32 32 32 32 32 32 32 32 32 
32 32 32 32 32 32 32 32 32 32 32 32 32 32 32 32 32 32 32 32 32 32 32 32 32 32 32 32 32 32 32 32 32 32 32 32 32 32 32 32 32 32 32 32 32 32 32 32 32 32 
32 32 32 32 32 32 32 32 32 32 32 32 32 32 32 32 32 32 32 32 32 32 32 32 32 32 32 32 32 32 32 32 32 32 32 32 32 32 32 32 32 32 32 32 32 32 32 32 32 32 
32 32 32 37 17 17 32 32 32 32 32 32 32 32 32 32 32 32 32 32 32 32 32 32 32 32 32 32 32 32 32 32 32 32 32 32 32 32 32 32 32 32 32 32 32 32 32 32 32 32 
32 32 32 17 17 17 17 32 32 32 32 32 32 32 32 32 32 32 32 32 32 32 32 32 32 32 32 32 32 32 32 32 32 32 32 32 32 32 32 32 32 32 32 32 32 32 32 32 32 32 
32 32 32 17 17 17 17 17 17 17 17 17 17 17 17 17 17 17 17 17 17 17 17 17 17 17 17 17 32 32 32 17 17 17 17 17 17 32 32 32 32 32 17 17 32 32 32 32 32 32 
32 32 32 32 17 17 17 32 17 17 17 17 17 17 17 17 17 17 17 17 17 17 17 17 17 17 17 17 32 32 17 17 17 17 17 17 17 17 32 32 32 17 17 17 17 32 32 32 32 32 
32 32 32 32 32 17 32 32 17 17 17 17 17 17 17 17 17 17 17 17 17 17 17 17 17 17 17 3 32 32 17 17 17 17 17 17 17 17 32 32 32 17 17 17 17 32 32 32 32 32 
32 32 32 32 32 17 17 17 17 17 17 17 17 32 17 17 17 17 17 17 17 17 17 17 17 17 3 3 32 32 17 17 17 3 17 17 17 17 32 32 32 17 17 17 17 32 32 32 32 32 
32 32 32 32 17 17 17 17 17 17 17 17 17 32 32 17 17 17 17 17 17 17 17 17 17 17 3 3 32 32 17 17 17 3 3 3 3 3 32 32 32 3 17 17 17 32 32 32 32 32 
32 32 32 32 17 17 17 17 17 17 17 17 17 32 32 17 17 17 17 17 17 17 17 17 17 17 3 32 32 32 17 17 17 17 17 3 3 3 32 32 32 17 17 17 17 32 32 32 32 32 
32 32 32 32 17 17 17 17 17 17 17 17 17 32 32 32 32 32 32 32 32 32 32 32 32 32 32 32 32 17 17 17 17 17 17 17 17 17 32 32 32 17 17 17 17 32 32 32 32 32 
32 32 32 32 17 17 17 17 17 17 17 17 32 32 32 32 32 32 32 32 32 32 32 32 32 32 32 32 17 32 17 17 17 17 17 17 17 17 32 32 32 17 17 17 17 32 32 32 32 32 
32 32 32 32 17 17 17 17 17 17 17 32 32 32 17 17 17 17 17 17 17 17 17 17 17 17 17 17 17 17 17 17 17 17 17 17 17 17 17 32 17 17 17 17 17 32 32 32 32 32 
32 32 32 32 17 17 17 17 17 17 32 32 32 17 17 17 17 17 17 17 17 17 17 17 17 17 17 17 17 17 17 17 17 17 17 17 17 17 17 17 17 17 17 17 17 32 32 32 32 32 
32 32 32 32 17 17 17 17 17 17 32 32 17 17 17 17 17 3 17 17 17 17 17 17 17 17 17 17 17 17 17 17 17 17 17 17 17 17 17 17 17 17 17 17 17 32 32 32 32 32 
32 32 32 32 17 17 17 17 17 17 17 17 17 17 17 17 17 3 3 17 17 17 17 17 17 17 17 17 17 17 17 17 17 17 17 17 17 17 17 17 17 17 17 17 32 32 32 32 32 32 
32 32 32 32 17 17 17 17 17 17 17 17 17 17 17 3 3 3 3 3 3 17 17 32 32 32 32 32 32 32 32 32 32 32 32 32 32 32 32 32 17 32 32 32 32 32 32 32 32 32 
32 32 32 32 32 17 17 17 17 17 17 17 17 17 17 17 17 17 17 17 17 17 32 32 32 32 32 32 32 32 32 32 32 32 32 32 32 32 32 32 17 17 32 32 32 32 32 32 32 32 
32 32 32 32 32 17 17 17 17 17 17 17 17 17 17 17 17 17 17 17 17 32 32 32 32 32 32 32 32 32 32 32 32 32 32 32 32 32 32 17 17 17 32 32 32 32 32 32 32 32 
32 32 32 32 32 17 17 17 17 17 17 17 17 17 17 17 17 17 17 17 17 32 32 32 17 17 17 17 17 17 17 17 17 17 17 17 17 17 17 17 17 17 17 17 32 32 32 32 32 32 
32 32 32 32 32 17 17 17 17 17 3 3 17 17 3 17 17 17 17 17 32 32 32 17 17 17 17 17 3 3 17 17 17 17 17 17 17 17 17 17 17 17 17 17 17 32 32 32 32 32 
32 32 32 32 32 17 17 17 17 3 3 3 17 17 3 17 17 17 32 17 32 32 17 17 17 17 17 3 3 3 3 3 17 17 17 17 17 17 17 17 17 17 17 17 17 32 32 32 32 32 
32 32 32 32 32 17 17 17 17 3 3 17 17 17 3 17 17 32 32 17 17 17 17 17 17 17 17 17 3 3 3 17 17 17 17 17 17 17 17 17 17 17 17 17 17 32 32 32 32 32 
32 32 32 32 32 17 17 17 17 3 3 17 17 17 3 3 32 32 32 17 17 17 17 17 17 17 17 17 17 17 17 17 17 17 17 17 17 17 17 17 17 17 17 17 17 32 32 32 32 32 
32 32 32 32 32 17 17 17 17 17 3 17 17 3 3 3 17 17 17 17 17 17 17 17 17 17 17 17 17 17 17 17 17 17 17 17 17 17 17 17 17 17 17 17 17 32 32 32 32 32 
32 32 32 32 32 17 17 17 17 3 3 3 3 17 17 32 32 17 17 17 17 17 17 17 17 17 17 17 17 17 17 17 17 17 17 17 17 17 17 17 17 17 17 17 17 32 32 32 32 32 
32 32 32 32 32 17 17 17 3 17 17 17 17 17 17 32 32 32 17 17 17 17 17 17 17 17 17 17 17 17 17 17 17 17 17 17 17 17 17 17 17 17 17 17 17 32 32 32 32 32 
32 32 32 32 32 17 17 17 17 17 17 17 17 17 17 32 32 32 17 17 17 17 17 17 17 17 17 17 17 17 17 17 17 17 17 17 17 17 17 17 17 17 17 17 17 32 32 32 32 32 
32 32 32 32 32 32 17 17 17 17 17 17 17 17 17 32 32 32 17 17 17 17 17 17 17 17 17 17 17 17 17 17 32 17 17 17 17 17 17 17 17 17 17 17 17 32 32 32 32 32 
32 32 32 32 32 32 32 32 32 32 32 32 17 17 17 32 32 32 17 17 3 3 3 3 17 17 17 17 17 17 17 17 32 17 17 17 17 17 17 17 17 17 17 17 17 32 32 32 32 32 
32 32 32 32 32 32 32 32 32 32 32 32 17 17 17 32 32 32 17 3 3 3 3 17 17 17 17 17 17 17 17 32 32 32 17 17 17 17 17 17 17 17 17 17 17 32 32 32 32 32 
32 32 32 32 32 32 32 32 32 32 32 32 17 17 17 32 32 32 17 17 3 3 17 17 17 17 17 17 17 17 32 32 32 32 32 3 3 3 3 3 17 17 17 17 17 32 32 32 32 32 
32 32 32 32 32 32 17 17 17 32 32 17 17 17 17 32 32 32 17 17 17 3 3 17 17 17 17 17 17 17 17 32 32 32 17 3 3 3 3 3 3 3 17 17 17 32 32 32 32 32 
32 32 32 32 32 17 17 17 17 17 17 17 17 17 17 32 32 32 17 17 17 3 3 17 17 17 17 17 17 17 17 17 32 17 3 3 3 3 3 3 3 3 3 17 17 32 32 32 32 32 
32 32 32 32 32 17 17 17 17 17 17 17 17 17 17 32 32 32 17 17 17 3 3 17 17 17 17 17 17 17 17 3 3 3 3 3 3 3 3 3 3 3 3 17 17 32 32 32 32 32 
32 32 32 32 32 17 17 17 3 3 3 3 17 17 17 32 32 32 17 17 17 17 17 17 17 17 17 17 17 17 17 17 3 3 3 3 3 3 3 3 3 3 17 17 17 32 32 32 32 32 
32 32 32 32 32 17 3 17 17 17 3 17 17 17 32 32 32 32 17 17 17 17 17 17 17 17 17 17 17 17 17 17 17 17 3 3 3 3 3 3 17 17 17 17 17 32 32 32 32 32 
32 32 32 32 32 17 17 17 32 32 32 32 32 32 32 32 32 32 17 17 17 17 17 17 17 17 17 17 17 17 17 17 17 17 17 17 17 17 17 17 17 17 17 17 17 32 32 32 32 32 
32 32 32 32 32 17 17 17 32 32 32 32 32 32 32 32 32 32 17 17 17 17 17 17 17 17 17 17 17 17 17 17 17 17 17 17 17 17 17 17 17 17 17 17 17 32 32 32 32 32 
32 32 32 32 32 17 17 17 17 17 17 17 17 17 32 32 32 32 17 17 17 17 17 17 17 17 17 17 17 17 17 17 17 17 17 17 17 17 17 17 17 17 17 17 17 32 32 32 32 32 
32 32 32 32 32 17 17 17 17 17 17 17 17 17 17 32 32 32 32 17 17 17 17 17 17 17 17 17 17 17 17 17 17 17 17 17 17 17 17 17 17 17 17 17 17 32 32 32 32 32 
32 32 32 32 32 17 17 17 17 17 17 17 17 17 17 32 32 32 32 32 17 17 17 17 17 17 17 17 17 17 17 17 17 17 17 17 17 17 17 17 17 17 17 17 17 32 32 32 32 32 
32 32 32 32 32 17 17 17 17 17 17 17 17 17 17 32 32 32 32 32 32 17 17 17 17 17 17 17 17 17 17 17 17 17 17 17 17 17 17 17 17 17 17 17 17 32 32 32 32 32 
32 32 32 32 32 32 17 17 3 3 3 3 3 3 32 32 32 32 32 32 32 32 17 17 17 17 17 17 17 17 17 17 17 17 17 17 17 17 17 17 17 17 17 17 36 32 32 32 32 32 
32 32 32 32 32 32 32 32 32 32 32 32 32 32 32 32 32 32 32 32 32 32 32 32 32 32 32 32 32 32 32 32 32 32 32 32 32 32 32 32 32 32 32 32 32 32 32 32 32 32 
32 32 32 32 32 32 32 32 32 32 32 32 32 32 32 32 32 32 32 32 32 32 32 32 32 32 32 32 32 32 32 32 32 32 32 32 32 32 32 32 32 32 32 32 32 32 32 32 32 32 
32 32 32 32 32 32 32 32 32 32 32 32 32 32 32 32 32 32 32 32 32 32 32 32 32 32 32 32 32 32 32 32 32 32 32 32 32 32 32 32 32 32 32 32 32 32 32 32 32 32 
32 32 32 32 32 32 32 32 32 32 32 32 32 32 32 32 32 32 32 32 32 32 32 32 32 32 32 32 32 32 32 32 32 32 32 32 32 32 32 32 32 32 32 32 32 32 32 32 32 32 
32 32 32 32 32 32 32 32 32 32 32 32 32 32 32 32 32 32 32 32 32 32 32 32 32 32 32 32 32 32 32 32 32 32 32 32 32 32 32 32 32 32 32 32 32 32 32 32 32 32 
